#######
#    S
#   ## 
#   ##
#    # 
# #####      
#E######