######
S   ##
##   #
#    #
##   E
######
######
    ##